Sudoku 1: 
-------------------------
| . 1 . | . 8 . | . 2 . |
| 5 . . | . . . | . . 1 |
| . 2 4 | 1 . 3 | 5 7 . |
|-----------------------|
| 1 . . | . . . | . . 5 |
| . . 5 | 8 . 9 | 4 . . |
| 9 . . | . . . | . . 7 |
|-----------------------|
| . 5 9 | 4 . 2 | 1 8 . |
| 4 . . | . . . | . . 2 |
| . 6 . | . 1 . | . 4 . |
-------------------------

Solution : 
-------------------------
| 3 1 7 | 5 8 6 | 9 2 4 |
| 5 9 8 | 7 2 4 | 3 6 1 |
| 6 2 4 | 1 9 3 | 5 7 8 |
|-----------------------|
| 1 8 3 | 6 4 7 | 2 9 5 |
| 2 7 5 | 8 3 9 | 4 1 6 |
| 9 4 6 | 2 5 1 | 8 3 7 |
|-----------------------|
| 7 5 9 | 4 6 2 | 1 8 3 |
| 4 3 1 | 9 7 8 | 6 5 2 |
| 8 6 2 | 3 1 5 | 7 4 9 |
-------------------------


Sudoku 2: 
-------------------------
| . . . | . . . | . . 1 |
| . . . | . . . | . 2 3 |
| . . 4 | . . 5 | . . . |
|-----------------------|
| . . . | 1 . . | . . . |
| . . . | . 3 . | 6 . . |
| . . 7 | . . . | 5 8 . |
|-----------------------|
| . . . | . 6 7 | . . . |
| . 1 . | . . 4 | . . . |
| 5 2 . | . . . | . . . |
-------------------------

Solution : 
-------------------------
| 6 7 2 | 9 8 3 | 4 5 1 |
| 9 5 1 | 4 7 6 | 8 2 3 |
| 3 8 4 | 2 1 5 | 9 7 6 |
|-----------------------|
| 4 6 8 | 1 5 9 | 2 3 7 |
| 2 9 5 | 7 3 8 | 6 1 4 |
| 1 3 7 | 6 4 2 | 5 8 9 |
|-----------------------|
| 8 4 3 | 5 6 7 | 1 9 2 |
| 7 1 9 | 8 2 4 | 3 6 5 |
| 5 2 6 | 3 9 1 | 7 4 8 |
-------------------------


Sudoku 3: 
-------------------------
| . . . | . . . | . . 1 |
| . . . | . . . | . 2 3 |
| . . 4 | . . 5 | . . . |
|-----------------------|
| . . . | 1 . . | . . . |
| . . . | . 3 . | 6 . . |
| . . 7 | . . . | 5 8 . |
|-----------------------|
| . . . | . 6 7 | . . . |
| . 1 . | . . 4 | . . . |
| 5 2 . | . . . | . . . |
-------------------------

Solution : 
-------------------------
| 6 7 2 | 9 8 3 | 4 5 1 |
| 9 5 1 | 4 7 6 | 8 2 3 |
| 3 8 4 | 2 1 5 | 9 7 6 |
|-----------------------|
| 4 6 8 | 1 5 9 | 2 3 7 |
| 2 9 5 | 7 3 8 | 6 1 4 |
| 1 3 7 | 6 4 2 | 5 8 9 |
|-----------------------|
| 8 4 3 | 5 6 7 | 1 9 2 |
| 7 1 9 | 8 2 4 | 3 6 5 |
| 5 2 6 | 3 9 1 | 7 4 8 |
-------------------------


